####............####
##..####K1..S1M1....
##....T1##M1....S1..
##..M3..####..M1####
....##**T1..........
T1..K2##..M1S1##....
..##T1##M2....####..
M1..##S1..T1##..K3##
C3......####M3T1....
C1C2....M2..........